111111111111111111111111111111111
101010000000000000000000100000001
101011111111111111101111111110111
101010000000000000000000000000001
101011111111111110111111111111111
101010100000000010100000000000001
101010111011111110101111111111111
101000100000100000000000000000001
101010111110111010111111111111111
101010100000000010000000000000001
101010111110111111111111111111111
101010100010001000000000000000001
101010101010111110111111111111111
101010101010100010000000000010101
101010111010101011111111111010101
101010100000001000001000100010001
101010111110111010101011101010101
101010101000001010101010001010101
101010101011101010101010111010101
100010101000101010101000100010101
101010101011111010101111101110101
101010101010101010101010100000101
101010101010101010101010101010101
101010101000101010101000001010101
101010101010101010111010111010101
101010100010001010001010100010101
101010101010111010101110101010101
101010101010101010100000101010101
101010101010101111101111111110101
101010001010001000000000000010101
111010101010101110111111111010111
100010101010101000000000001010001
111111111111111111111111111111111
